10.ox
..........
....oo....
......o...
o.oo......
..........
...o......
..........
..........
.......o..
..........
